1 1 1 1 1 1 1 1 1 1 1 1 1 1 1 1 1 1 1 1 1 232 262 262 161 161 161 161 161 161
1 1 1 1 1 1 1 1 1 1 1 1 1 1 1 1 1 1 1 1 1 232 262 262 161 161 161 161 161 161
1 1 1 1 1 1 1 1 1 1 1 1 1 1 1 1 1 1 1 1 1 232 262 262 161 161 161 161 161 161
2 2 2 2 2 2 2 2 2 3 1 1 1 1 1 1 1 1 1 1 1 233 208 208 161 161 161 161 161 161
0 0 0 0 0 0 0 0 0 4 1 1 1 1 1 1 1 1 1 1 1 1 1 1 161 161 161 161 161 161
9 9 9 9 9 9 9 10 0 4 1 1 1 1 1 1 1 1 1 1 1 1 1 1 161 161 161 161 161 161
1 1 1 1 1 1 1 7 0 4 1 1 1 1 1 1 1 8 2 2 2 2 2 2 161 161 161 161 161 161
1 1 1 1 1 1 1 7 0 4 1 1 1 1 1 1 1 7 0 0 0 0 0 0 161 161 161 161 161 161
1 1 1 1 1 1 1 7 0 4 1 1 1 1 1 1 1 7 0 13 9 9 9 9 161 161 161 161 161 161
1 1 1 1 1 1 1 7 0 5 2 2 2 2 2 2 2 6 0 4 1 1 1 1 161 161 161 161 161 161
1 1 1 1 1 1 1 7 0 0 0 0 0 0 0 0 0 0 0 4 1 1 1 1 161 161 161 161 161 161
1 1 1 1 1 1 1 11 9 9 9 9 9 9 9 9 9 9 9 12 1 1 1 1 161 161 161 161 161 161
1 1 1 1 1 1 1 1 1 1 1 1 1 1 1 1 1 1 1 1 1 1 1 1 161 161 161 161 161 161
1 1 1 1 1 1 1 1 1 1 1 1 1 1 1 1 1 1 1 1 1 1 1 1 161 161 161 161 161 161
1 1 1 1 1 1 1 1 1 1 1 1 1 1 1 1 1 1 1 1 1 1 1 1 161 161 161 161 161 161
1 1 1 1 1 1 1 1 1 1 1 1 1 1 1 1 1 1 1 1 1 1 1 1 0 0 0 0 0 0
1 1 1 1 1 1 1 1 1 1 1 1 1 1 1 1 1 1 1 1 1 1 1 1 0 0 0 0 0 0
1 1 1 1 1 1 1 1 1 1 1 1 1 0 0 1 1 1 1 1 1 1 1 1 0 0 0 0 0 0
1 1 1 1 1 1 1 1 1 1 1 1 1 0 0 1 1 1 1 1 1 1 1 1 0 0 0 0 0 0
0 0 0 0 0 0 0 0 0 1 1 1 1 1 1 1 1 1 1 1 1 1 1 1 0 0 0 0 0 0
1 1 1 1 1 1 1 0 0 1 1 1 1 1 1 1 1 1 1 1 1 1 1 1 0 0 0 0 0 0
1 1 1 1 1 1 1 1 0 1 1 1 1 1 1 1 1 1 1 1 1 1 1 1 0 0 0 0 0 0
1 1 1 1 1 1 1 1 0 1 1 1 1 1 1 1 1 1 0 0 0 0 0 0 0 0 0 0 0 0
1 1 1 1 0 0 1 1 0 1 0 1 1 1 1 1 1 1 0 0 1 1 1 1 0 0 0 0 0 0
1 1 1 1 0 0 1 1 0 0 1 1 1 1 1 1 1 0 0 1 1 1 1 1 0 0 0 0 0 0
1 1 1 1 1 1 1 1 0 0 0 0 0 0 0 0 0 0 0 1 1 1 1 1 0 0 0 0 0 0
1 1 1 1 1 1 1 1 1 1 1 1 1 1 1 1 1 1 1 1 1 1 1 1 0 0 0 0 0 0
1 1 1 1 1 1 1 1 1 1 1 1 1 1 1 1 1 1 1 1 1 1 1 1 0 0 0 0 0 0
1 1 1 1 1 1 1 1 1 1 1 1 1 1 1 1 1 1 1 1 1 1 1 1 0 0 0 0 0 0
1 1 1 1 1 1 1 1 1 1 1 1 1 1 1 1 1 1 1 1 1 1 1 1 0 0 0 0 0 0